"RANK","2020 RANK","COMPANY","CITY","STATE","USDOT","EXECUTIVE","TITLE","WEBSITE","PRIMARY OPERATION","CARRIERS","2020 REVENUE","LEASED TRUCKS","OWNED TRUCKS","TOTAL TRUCKS","LEASED TRACTORS","OWNED TRACTORS","TOTAL TRACTORS","LEASED TRAILERS","OWNED TRAILERS","TOTAL TRAILERS","COMPANY DRIVERS","INDEPENDENT CONTRACTOR DRIVERS","TOTAL DRIVERS"
"1","2","FedEx Corp.","Memphis","TN","","Frederick W. Smith","Chairman, Pres., & CEO","www.fedex.com","Packages","FedEx Express/FedEx Freight/FedExGround/FedEx Supply Chain/FedEx Custom Critical","46618000000","75573","33403","108976","15498","21384","36882","67","132393","132460","0","0","232579"
"2","1","UPS/United Parcel Service, Inc.","Atlanta","GA","","Carol B. Tomé","CEO","www.ups.com","Packages","UPS/Worldwide Dedicated Services/UPS Cartage/UPS Supply Chain Inc.","56065000000","10","100652","100662","0","21957","21957","0","120951","120951","0","0","119335"
"3","3","J.B. Hunt Transport, Inc.","Lowell","AR","80806","John N. Roberts, III","President and CEO","www.jbhunt.com","General Freight","","9640000000","359","667","1026","1562","16269","17831","7929","111986","119915","","","21325"
"4","4","Knight-Swift Holdings","Phoenix","AZ","","Dave Jackson","CEO","www.knight-swift.com","General Freight","Swift Transportation Co./Knight Transportation Co/Bar-Nunn/TransMex/AAA Cooper","4673863000","0","0","0","1099","17349","18448","14455","53871","68326","17400","2069","19469"
"5","5","Yellow Corp.","Overland Park","KS","","James L. Welch","CEO","www.yrcw.com","General Freight","","4513700000","140","404","544","3835","10051","13886","12006","31406","43412","","","17827"
"6","6","XPO Logistics, Inc.","Greenwich","CT","281716","Bradley Jacobs","Founder & CEO","www.xpo.com","General Freight","XPO Logistics, Inc.","7531000000","151","160","311","2677","8382","11059","1909","27211","29120","0","0","15072"
"7","8","TFI International","Saint-Laurent","QC","","Alain Bédard","Chairman of the Board, President & CEO","www.tfiintl.com","General Freight","Toronto Tank Lines/Schilli Corp./Les Services JAG/Aulick Leasing Corp./BeavEx Inc./Piston Tank Corp./AT Group US Logistics, LLC/Craler Inc.","3781134000","0","0","0","2014","11531","13545","949","47904","48853","24062","10248","34310"
"8","7","Schneider","Green Bay","WI","","Mark Rourke","President & CEO","www.schneider.com","General Freight","","4552800000","0","30","30","2715","8833","11548","1","34510","34511","0","0","13029"
"9","9","Landstar System, Inc.","Jacksonville","FL","","Jim B. Gattoni","President & CEO","www.landstar.com","General Freight","Landstar Ranger/Landstar Express America/Landstar Inway/Landstar Gemini/Landstar Ligon/Landstar Global Logistics/Landstar Canada","4132981000","236","0","236","10007","0","10007","4334","12733","17067","0","10243","10243"
"10","10","Old Dominion Freight Line, Inc.","Thomasville","NC","107478","David S. Congdon","Executive Chairman","www.odfl.com","General Freight","Old Dominion Freight Line, Inc.","4015129000","0","139","139","0","9527","9527","0","37853","37853","11205","0","11205"
"11","12","Estes Express Lines","Richmond","VA","","Rob Estes","President & CEO","www.estes-express.com","General Freight","Estes Express Lines/GI Trucking Company/Estes Forwarding Worldwide/Level 2 Logistics/Big E Transportation/Estes Final Mile/Estes SureMove/Estes Truckload Management/Eastern Freightways, Inc.","3559155000","0","468","468","0","8053","8053","0","31443","31443","9485","0","9485"
"12","19","Penske Logistics","Reading","PA","268015","Marc Althen","President","www.penskelogistics.com","Dedicated Contract Carriage","Penske Logistics/Epes Transport/Black Horse Carriers","3400000000","837","0","837","6659","0","6659","21998","0","21998","10889","197","11086"
"13","11","Werner Enterprises, Inc.","Omaha","NE","53467","Derek J. Leathers","President & CEO","www.werner.com","General Freight","Werner Enterprises, Inc.","2372178000","0","40","40","534","9118","9652","0","23235","23235","","","9689"
"14","13","Ryder Supply Chain Solutions","Miami","FL","165420","J. Steven Sensing","President, Global Supply Chain Solutions","www.ryderscs.com","Dedicated Contract Carriage","","3773794000","735","0","735","4949","0","4949","9942","0","9942","","","9098"
"15","14","Prime, Inc.","Springfield","MO","3706","Robert E. Low","President","www.primeinc.com","Refrigerated","Prime, Inc.","2167914000","0","0","0","0","6733","6733","0","14162","14162","3110","5450","8560"
"16","15","U.S. Xpress Enterprises, Inc.","Chattanooga","TN","","Ray Harlin","President","www.usxpress.com","General Freight","","1742101000","0","45","45","0","7177","7177","0","17330","17330","","","8452"
"17","18","R+L Carriers","Wilmington","OH","","Ralph L. Roberts","CEO","www.rlcarriers.com","General Freight","","-","1","705","706","35","6016","6051","0","18439","18439","","","8030"
"18","23","Evans Network of Companies","Schuylkill Haven","PA","","Matthew "Bo" Bates","President & CEO","www.evansdelivery.com","Intermodal","Evans Delivery/West Motor Freight/Hale Intermodal/All Points Transport/Century Express/DM/Trans Land Transportation/Phoenix Transit & Logistics/Commercial Transportation LLC & Drayage Express of DE LLC/Madaris Transportation/Catfish Container/Pierside/National Drayage Services","1426000000","0","0","0","7500","0","7500","500","500","1000","0","7500","7500"
"19","16","Kenan Advantage Group","North Canton","OH","","Charlie DeLacey","CEO","www.thekag.com","Tank/Bulk Commodities","Kenan/Advantage Tank/KAG West/Klemm Tank/BXI/North Canton Transfer/Petro-Chemical/KAG Specialty Products/KAG Food Products/KAG Merchant Gas/RTL-Westcan/Ag Trucking","1572138000","0","0","0","1699","5155","6854","392","11891","12283","4998","1473","6471"
"20","21","Saia Inc.","Johns Creek","GA","29124","Rick O'Dell","CEO","www.saia.com","General Freight","","1822366000","0","62","62","0","5949","5949","0","16674","16674","","","5523"
"21","24","NFI","Camden","NJ","1486168","Sidney Brown","CEO","www.nfiindustries.com","Dedicated Contract Carriage","National Freight, Inc./NFI Interactive Logistics/California Cartage Co./G&P Transportation","2630000000","0","2","2","1700","2900","4600","1500","11500","13000","3900","1700","5600"
"22","22","Daseke","Addison","TX","","Brian Bonner","Chairman","www.daseke.com","Flatbed/Specialized/Heavy Haul","Smokey Point Distributing/Belmont Enterprises/E.W. Wylie/Big Freight Systems/Kelsey Trail Trucking/J. Grady Randolph/Central Oregon Trucking Company/Boyd Bros./WTI/Mid Seven Transportation/Lonestar Transportation/Steelman Transportation/Group One/Bulldog Highway Express/Hornady Transportation/Tri-State/Tennessee Steel Haulers/Alabama Carriers/Fleet Movers","1454100000","11","79","90","2499","3010","5509","2074","11017","13091","","","5670"
"23","20","CRST International, Inc.","Cedar Rapids","IA","","Hugh Ekberg","President and CEO","www.crst.com","General Freight","CRST Expedited/CRST Malone/CRST Dedicated/Specialized Transportation Inc./Gardner Trucking/BESL Transfer/Pegasus Transportation","1503000000","0","0","0","0","4888","4888","0","13800","13800","4529","1713","6242"
"24","17","ArcBest","Fort Smith","AR","","Judy R. McReynolds","Chairman, President & CEO","arcb.com","General Freight","ABF Freight/ArcBest/Panther Logistics","2940163000","0","83","83","0","4136","4136","897","21879","22776","700","4000","4700"
"25","29","Crete Carrier Corporation","Lincoln","NE","","Tonn Ostergard","President & CEO","www.cretecarrier.com","General Freight","Crete Carrier Corporation, Hunt Transportation, Shaffer Trucking","1185765571","0","0","0","344","5309","5653","0","13929","13929","5309","344","5653"
"26","30","Universal Logistics Holdings, Inc.","Warren","MI","","Tim Phillips","CEO","www.goutsi.com","General Freight","","1391083000","251","2","253","4267","574","4841","2955","2824","5779","","","5056"
"27","119","Day & Ross","Hartland","NB","19176","Bill Doherty","CEO","www.dayross.com","Dedicated Contract Carriage","Day & Ross","1359497899","350","250","600","2600","1600","4200","1000","7600","8600","1500","4000","5500"
"28","65","10 Roads Express","South Holland","IL","649914","Timothy R. Pals","CCO","www.eagleexpresslines.com","Dedicated contract carriage","","-","0","195","195","0","5338","5338","0","5394","5394","","","6902"
"29","26","CR England, Inc.","Salt Lake City","UT","28406","Daniel E England","Chairman","www.crengland.com","Refrigerated","CR England, Inc.","1466947000","0","0","0","12","3833","3845","0","5749","5749","5375","11","5386"
"30","28","Averitt Express","Cookeville","TN","36684","Gary D. Sasser","Chairman & CEO","www.averittexpress.com","General Freight","Averitt Express, Inc.","1207587000","0","41","41","0","4733","4733","0","14487","14487","5442","0","5442"
"31","27","Hub Group","Oak Brook","IL","1454112","Phillip Yeager","President & COO","www.hubgroup.com","Intermodal","Hub Group Trucking","3495644000","0","5","5","809","2385","3194","575","49300","49875","2400","800","3200"
"32","32","Ruan","Des Moines","IA","","Ben McLean","CEO","www.ruan.com","Dedicated Contract Carriage","Ruan Transport Corp./Ruan Logistics Corporation","1222781800","35","69","104","244","3296","3540","701","8767","9468","4000","0","4000"
"33","25","UniGroup","Fenton","MO","","Marc Rogers","President & CEO","www.unigroup.com","Household Goods","United Van Lines/Mayflower Transit/UniGroup Logistics","1300000000","2049","0","2049","2889","0","2889","4767","0","4767","0","3200","3200"
"34","31","Southeastern Freight Lines","Lexington","SC","63419","Tobin Cassels","President","www.sefl.com","General Freight","Southeastern Freight Lines","1256332671","0","408","408","0","2847","2847","0","7886","7886","4308","0","4308"
"35","35","Central Transport International, Inc.","Warren","MI","661173","Manuel Moroun","Chairman & CEO","www.centraltransportint.com","General Freight","","-","149","0","149","3580","0","3580","8675","0","8675","","","4177"
"36","34","Quality Distribution, Inc.","Tampa","FL","","Gary R. Enzor","Chairman and CEO","www.qualitydistribution.com","Tank/Bulk Commodities","","-","0","1","1","2786","341","3127","7966","4673","12639","","","4496"
"37","36","PS Logistics","Birmingham","AL","1243338","Scott Smith","CEO","www.pstrans.com","Flatbed/Specialized/Heavy Haul","P&S Transportation, LLC/Blair Logistics, LLC/Shelton Trucking, LLC/MTB Transport, LLC/Purdy Brothers Trucking, LLC/Loudon County Trucking, LLC/TA Services, LLC/DT Freight, LLC/Red Mountain Transportation, LLC/National Strategic Transport, LLC/HS Express, LLC/DMT Trucking, LLC/Southeast Logistics & Transport, LLC/Riechmann Transport/Celadon Logistics Services, Inc./J. Carter Trucking, Inc./Curry's Transportation Service, Inc.","957000000","0","0","0","1750","1775","3525","2075","4075","6150","1750","1775","3525"
"38","38","Covenant Transportation Group, Inc.","Chattanooga","TN","","David R. Parker","Chairman & CEO","www.covenanttransport.com","General Freight","","838561000","1","0","1","1703","1750","3453","198","5897","6095","","","4641"
"39","41","DHL Express Americas","Plantation","FL","","Mike Parra","CEO","www.dhl-usa.com","Packages","","4534882000","209","74","283","903","363","1266","2684","729","3413","","","4076"
"40","44","Marten Transport, Ltd.","Mondovi","WI","74432","Randy Marten","CEO","www.marten.com","Refrigerated","Marten Transport, Ltd.","874374000","0","0","0","0","3331","3331","0","5299","5299","3116","105","3221"
"41","43","SIRVA, Inc.","Westmont","IL","","Wes Lucas","President & CEO","www.sirva.com","Household Goods","","-","688","0","688","1766","0","1766","3209","146","3355","","","3406"
"42","39","Heartland Express, Inc.","North Liberty","IA","","Michael Gerdin","Chairman, President & CEO","www.heartlandexpress.com","General Freight","Heartland Express/Millis Transfer","645262000","0","0","0","20","3500","3520","0","10300","10300","3500","20","3520"
"43","37","Cardinal Logistics Management Corp.","Concord","NC","191496","Vin McLoughlin","Chairman","www.cardlog.com","Dedicated Contract Carriage","Cardinal Logistics Management Corporation/Greatwide Dedicated Transport/Am-Can","849000000","0","140","140","0","3100","3100","0","8000","8000","3100","300","3400"
"44","57","Bennett Family of Companies","McDonough","GA","","Marcia Taylor","President, CEO","www.bennettig.com","Flatbed/Specialized/Heavy Haul","Bennett Motor Express/Ace Doran Hauling & Rigging Co./Bennett Heavy & Specialized/Bennett Truck Transport/Bennett DriveAway/Boss Crane & Rigging/RoadMasters/American Eagle","693195785","0","1","1","4004","167","4171","2558","1443","4001","103","3045","3148"
"45","42","KLLM Transport Services, LLC","Richland","MS","154237","James M. Richards, Jr","President & CEO","www.kllm.com","Refrigerated","KLLM Freight Services/FFE Transportation Services","917000000","0","0","0","0","3400","3400","0","6300","6300","","","3032"
"46","45","Anderson Trucking Service, Inc.","Saint Cloud","MN","","Paul A. Pfeiffer","CFO","www.atsinc.com","Flatbed/Specialized/Heavy Haul","ATS Specialized/ATS/SunBelt Furniture Xpress/Warren Transport/New Energy Transport/Midwest Specialized Transport","1274709000","0","0","0","1566","1140","2706","0","7209","7209","1140","1566","2706"
"47","40","Stevens Transport, Inc.","Dallas","TX","79466","Steve Aaron","Chairman & Founder","www.stevenstransport.com","Refrigerated","Stevens Transport, Inc.","701000000","0","0","0","1000","1350","2350","0","3850","3850","2900","1550","4450"
"48","46","Pitt Ohio Express LLC","Pittsburgh","PA","","Charles L. Hammel III","President","www.pittohio.com","General Freight","Pitt Ohio Express/ECM Transport/US Cargo","829407000","0","773","773","57","2036","2093","0","6447","6447","3483","1","3484"
"49","48","Western Express, Inc.","Nashville","TN","511412","Paul Wieck","CEO","www.westernexp.com","General Freight","Western Express","791428000","0","0","0","2850","150","3000","6000","2200","8200","2800","400","3200"
"50","33","Forward Air Corp.","Greeneville","TN","","Tom Schmitt","Chairman & CEO","www.forwardair.com","General Freight","","1269573000","1500","175","1675","1215","135","1350","5280","580","5860","555","1880","2435"
"51","50","FirstFleet, Inc.","Murfreesboro","TN","313891","Gary L. Wilson","President","www.firstfleetinc.com","Dedicated Contract Carriage","","-","0","0","0","0","2972","2972","0","10920","10920","","","3261"
"52","55","Bison Transport, Inc.","Winnipeg","MB","245330","Rob Penner","President & CEO","www.bisontransport.com","General Freight","Bison Transport, Inc./Britton Transport/Searcy Trucking/H.O. Wolding","642930420","0","0","0","905","1250","2155","0","6462","6462","1581","1013","2594"
"53","52","TMC Transportation/Annett Holdings, Inc.","Des Moines","IA","87409","Harold W. Annett","Chairman & CEO","www.tmctrans.com","Flatbed/Specialized/Heavy Haul","","-","0","0","0","175","2735","2910","21","4056","4077","","","3067"
"54","56","Cowan Systems LLC","Baltimore","MD","548880","Joseph Cowan","CEO","www.cowansystems.com","General Freight","Cowan Systems LLC/Carlisle Carrier LLC","575872000","0","0","0","541","1841","2382","404","7137","7541","1874","522","2396"
"55","51","Mercer Transportation Co., Inc.","Louisville","KY","154712","James L. Stone","President","www.mercer-trans.com","Flatbed/Specialized/Heavy Haul","Mercer Transportation Co., Inc.","489622260","0","0","0","2234","0","2234","1650","600","2250","0","2634","2634"
"56","58","Dayton Freight Lines, Inc.","Dayton","OH","273301","Thomas L. Cronin, Jr.","President","www.daytonfreight.com","General Freight","Dayton Freight Lines, Inc./Kelley Transportation (Truckload Division)","669000000","0","166","166","0","1876","1876","0","4846","4846","2394","0","2394"
"57","68","RoadOne IntermodaLogistics","Randolph","MA","2365308","Ken Kellaway Jr.","President & CEO","www.roadone.com","Intermodal","United Global Logistics/US IntermodaLogisitcs/American IntermodaLogistics/First Coast IntermodaLogistics/Mile High IntermodaLogistics/GuideOne IntermodaLogistics/Crown IntermodaLogistics","396000000","15","0","15","2316","60","2376","369","13","382","2309","102","2411"
"58","59","P.A.M. Transportation Services, Inc.","Tontitown","AR","179752","Joe Vitiritto","President & CEO","www.pamtransport.com","General Freight","P.A.M. Transport Inc.","486825000","0","0","0","355","1658","2013","0","7220","7220","2021","449","2470"
"59","61","Roehl Transport, Inc.","Marshfield","WI","74481","Richard Roehl","President","www.roehl.net","General Freight","Roehl Refrigerated Transport, LLC","450302393","0","7","7","52","2056","2108","0","5777","5777","2146","237","2383"
"60","54","United Road Services, Inc.","Plymouth","MI","790261","Mark Anderson","CEO","www.unitedroad.com","Motor Vehicles","United Road Services, Inc./Team Drive-Away, Inc.","545000000","0","0","0","1017","1000","2017","1017","1000","2017","790","1017","1807"
"61","64","Hirschbach Motor Lines, Inc.","Dubuque","IA","65769","Brad Pinchuk","CEO","www.hirschbach.com","Refrigerated","Hirschbach Motor Lines, Inc.","532531000","0","0","0","1254","612","1866","2","3413","3415","612","1254","1866"
"62","63","Trimac Transportation","Calgary","AB","","Mathew Faure","CEO","www.trimac.com","Tank/Bulk Commodities","","-","0","0","0","911","776","1687","38","2714","2752","","","1717"
"63","62","Atlas Van Lines, Inc.","Evansville","IN","125550","Jack Griffin","Chairman & CEO","www.atlasworldgroup.com","Household Goods","Atlas Van Lines, Inc.","605520597","1636","0","1636","1813","0","1813","3744","0","3744","0","1151","1151"
"64","66","Hogan Transports, Inc.","St. Louis","MO","226618","David Hogan","President","www.hogan1.com","General Freight","Hogan Transports","-","0","0","0","0","2100","2100","0","2900","2900","2300","0","2300"
"65","67","Heniff Transportation Systems","Oak Brook","IL","87844","Robert J. Heniff","CEO","www.heniff.com","Tank/Bulk Commodities","","525000000","0","0","0","925","900","1825","2000","1950","3950","925","900","1825"
"66","70","US 1 Industries","Valpariso","IN","","David Antonson","President","www.us1industries.com","Intermodal","","-","0","0","0","2021","40","2061","322","0","322","","","2062"
"67","69","CEVA Logistics Americas","Houston","TX","","Shawn Stewart","Executive Vice President, Freight Management, North America","www.cevalogistics.com","General Freight","","-","623","18","641","1179","57","1236","3016","238","3254","","","2527"
"68","60","USAT Capacity Solutions","Van Buren","AR","213754","James D. Reed","President & CEO","www.usa-truck.com","General Freight","USA Truck, Inc.","551138000","0","0","0","107","1236","1343","0","5634","5634","1335","692","2027"
"69","75","IMC Companies","Memphis","TN","292991","Mark H George","Chairman","www.imcc.com","Intermodal","Atlantic Intermodal Services/DNJ Intermodal Services/Gulf Intermodal Services/H&M Intermodal Services/Intermodal Cartage Company/Ohio Intermodal Services/Pacific Drayage Services/TransInternational Systems","450577000","0","0","0","1200","500","1700","0","150","150","500","1200","1700"
"70","80","A Duie Pyle, Inc.","West Chester","PA","113594","John Luciani","COO","www.aduiepyle.com","General Freight","A Duie Pyle, Inc.","504000000","0","159","159","76","1296","1372","64","2534","2598","1832","23","1855"
"71","74","MVT Services LLC/Mesilla Valley Transportation","Las Cruces","NM","270179","Royal Jones","President","www.m-v-t.com","General Freight","MVT Services, Inc./Mesilla Valley Transportation","399317364","0","0","0","220","1420","1640","0","5600","5600","1200","200","1400"
"72","81","Kaplan Trucking Co./Horizon Freight System, Inc.","Cleveland","OH","","David Ferrante","President","www.horizonfreightsystem.com","Intermodal","","-","0","0","0","975","696","1671","564","100","664","","","1671"
"73","77","Paladin Captal Inc.","Nashville","TN","757161","William Prevost","Chairman & CEO","www.paladin-capital.com","Dedicated Contract Carriage","Quickway Carriers/Quickway Transportation/Quickway Services/Volunteer Express/Robert Bearden/Dolphin Line/SNL Distribution Services","350000000","0","14","14","1400","250","1650","1525","1100","2625","1500","27","1527"
"74","78","Jack Cooper Transport Co. Inc.","Kansas City","MO","64161","Robert G. Griffin","Chief Executive Officer","www.jackcooper.com","Motor Vehicles","","-","0","0","0","0","1424","1424","0","1434","1434","","","1297"
"75","79","Maverick USA, Inc.","Little Rock","AR","178538","Steve Williams","CEO","www.maverickusa.com","Flatbed/Specialized/Heavy Haul","Maverick Transportation, LLC","358182477","0","0","0","55","1448","1503","30","2345","2375","1453","79","1532"
"76","87","Foodliner/Quest Liner Inc.","Dubuque","IA","","Greg McCoy","President","www.foodliner.com","Tank/Bulk Commodities","Foodliner, Inc./Quest Liner, Inc./W.W. Transport, Inc.","325842200","0","0","0","263","1300","1563","0","2917","2917","1131","263","1394"
"77","82","Challenger Motor Freight Inc.","Cambridge","ON","247765","Dan Einwechter","Chairman & CEO","www.challenger.com","General Freight","Challenger Motor Freight/Motor City Express/Elgin Motor Freight/Cam Hiltz Trucking/Lodwick Transport","345000000","0","1","1","0","1350","1350","0","3375","3375","1120","232","1352"
"78","102","A&R Logistics, Inc.","Morris","IL","","Mark Holden","CEO","www.ARDoingitRight.com","Tank/Bulk Commodities","A&R Logistics/L.T. Harnett/First Choice Logistics/RJ's Transportation/Luckey Tank Lines","-","1","13","14","588","826","1414","541","2175","2716","","","1272"
"79","83","Central Freight Lines, Inc.","Waco","TX","117034","Don Orr","Chairman","www.centralfreight.com","General Freight","","-","0","183","183","104","1315","1419","0","4507","4507","","","1325"
"80","86","Mr. Bult's, Inc.","Burnham","IL","387102","Tony Schmidt","President","www.mrbults.com","Tank/Bulk Commodities","","323000000","0","0","0","26","1344","1370","0","3070","3070","1150","23","1173"
"81","85","Lynden Companies","Anchorage","AK","","Jon Burdick","President & CEO","www.lynden.com","Intermodal","Alaska Marine Lines/Alaska West Express/Brown Line/Lynden Air Cargo/Lynden International/Lynden Transport/LTI, Inc.","960000000","0","100","100","100","800","900","0","2400","2400","850","100","950"
"82","89","ContainerPort Group, Inc.","Cleveland","OH","232734","Michael Smith","President","www.containerport.com","Intermodal","","350000000","0","0","0","1168","3","1171","0","0","0","3","1168","1171"
"83","84","Melton Truck Lines, Inc.","Tulsa","OK","34666","Robert A Peterson","Chairman & CEO","www.meltontruck.com","Flatbed/Specialized/Heavy Haul","Melton Truck Lines, Inc.","292125414","0","0","0","0","1290","1290","0","2208","2208","1110","0","1110"
"84","71","Wheaton Van Lines, Inc.","Indianapolis","IN","","Mark Kirschner","CEO","www.wheatonworldwide.com","Household Goods","","-","204","31","235","909","46","955","977","394","1371","","","1349"
"85","88","Transport Investments, Inc.","Pittsburgh","PA","","Douglas B. McAdams","President","www.thetii.com","Flatbed/Specialized/Heavy Haul","","-","1","0","1","1257","0","1257","1330","0","1330","","","1262"
"86","91","The Dana Companies","Avenel","NJ","","Ronald Dana","President","www.danacompanies.com","Tank/Bulk Commodities","","-","0","1","1","785","500","1285","20","3065","3085","","","1226"
"87","93","Paschall Truck Lines, Inc.","Murray","KY","105234","David A. Gibbs","President & CEO","www.ptl-inc.com","General Freight","Paschall Truck Lines, Inc.","240000000","0","0","0","125","1050","1175","0","3500","3500","1170","50","1220"
"88","101","May Trucking Co.","Salem","OR","94081","David Daniels","President","www.maytrucking.com","Refrigerated","May Trucking Co.","216724809","0","0","0","15","1069","1084","0","2800","2800","1060","15","1075"
"89","73","Dart Transit Co.","Eagan","MN","","Donald Oren","Chairman","www.dart.net","General Freight","Dart Transit Co./Dart Express/Mainstream Transportation","291838000","0","0","0","139","923","1062","4000","5035","9035","408","654","1062"
"90","76","JHT Holdings, Inc.","Pleasant Prairie","WI","","John Harrington","CEO","www.jhtholdings.com","Motor Vehicles","Auto Truck Transport/Active USA/Unimark Truck Transport/Equipment Transfer/Active Canada/Unimark Lowboy Transportation","334417000","0","3","3","110","883","993","0","140","140","883","110","993"
"91","99","Hansen & Adkins Auto Transport","Los Alamitos","CA","568253","Louie Adkins","President","www.hansenadkins.com","Motor Vehicles","","-","0","0","0","311","914","1225","311","914","1225","","","914"
"92","161","Tri-National, Inc.","Earth City","MO","1266329","Robert Rogulic","President","www.tri-nat.com","General Freight","Tri-National, Inc./Shoreline/Gulf Coast Intermodal","-","0","0","0","0","970","970","0","2985","2985","1360","0","1360"
"93","96","Stan Koch & Sons Trucking, Inc.","Minneapolis","MN","146060","Dave Koch","CEO","www.kochtrucking.us","General Freight","Stan Koch & Sons Trucking, Inc.","324813264","0","300","300","39","929","968","0","5652","5652","840","34","874"
"94","105","C.A.T. Inc.","Coteau Du Lac","QC","247969","Daniel Goyette","President","www.cat.ca","General Freight","","230000000","0","0","0","700","350","1050","2100","1000","3100","700","400","1100"
"95","100","Trans-System, Inc.","Spokane","WA","","Dennis J. Williams","President & CEO","www.trans-system.com","General Freight","System Transport, Inc./T-W Transport, Inc./James J. Williams","273000000","0","0","0","221","783","1004","70","1833","1903","746","232","978"
"96","94","Martin Transportation Systems, Inc.","Byron Center","MI","215732","Richard E. Johnson","President","www.mtstrans.com","Dedicated contract carriage","","-","0","0","0","15","1025","1040","0","2150","2150","","","1247"
"97","104","Carter Express","Anderson","IN","223337","Jessica Paugh Warnke","President & CEO","www.carter-express.com","Dedicated Contract Carriage","Carter Express, Inc.","251000000","0","1","1","72","900","972","650","11200","11850","950","82","1032"
"98","113","TransWood Carriers, Inc.","Omaha","NE","","Brian K. Wood","President","www.transwood.com","Tank/Bulk Commodities","","-","0","0","0","381","710","1091","7","1567","1574","","","1050"
"99","47","Roadrunner Freight","Downers Grove","IL","","Frank Hurst","President","www.rrts.com/freight","General Freight","","-","0","0","0","893","0","893","1107","94","1201","","","852"
"100","98","Wilson Logistics","Springfield","MO","1009435","Darrel Wilson","President & CEO","www.wilsonlogistics.com","General Freight","Wilson Logistics/Market Transport","234000000","0","0","0","343","630","973","0","2027","2027","576","419","995"
"101","103","PGT Trucking, Inc.","Aliquippa","PA","192897","Gregg Troian","President","www.pgttrucking.com","Flatbed/Specialized/Heavy Haul","","258400000","0","0","0","584","427","1011","135","1378","1513","376","507","883"
"102","123","New Legend Inc","Phoenix","AZ","1419483","Baveljit Samara","President & Owner","www.newlegendinc.com","General Freight","","190000000","0","150","150","0","1000","1000","100","4500","4600","1000","0","1000"
"103","107","Midwest Logistics Systems LTD","Celina","OH","774374","Edward Welker","President","www.midwestlogisticssystems.com","General Freight","","-","0","0","0","945","0","945","3484","0","3484","","","1087"
"104","97","Groendyke Transport, Inc.","Enid","OK","4247","Greg Hodgen","President","www.groendyke.com","Tank/Bulk Commodities","Groendyke Transport, Inc./McKenzie Tank Lines","207654547","0","1","1","141","918","1059","269","1519","1788","876","0","876"
"105","112","Paper Transport Inc","De Pere","WI","380482","Jeff Shefchik","President","www.papertransport.com","General Freight","Paper Transport","252860000","0","4","4","30","850","880","0","3000","3000","870","30","900"
"106","110","K.L. Breeden & Sons LLC","Terrell","TX","1836511","Chad Davis","Executive Vice President","www.klbsons.com","General Freight","","-","0","0","0","960","0","960","551","192","743","","","943"
"107","121","C&K Trucking LLC","Chicago Ridge","IL","540864","Michael Burton","President","www.cktrucking.com","Intermodal","","-","0","0","0","934","1","935","821","72","893","","","934"
"108","120","Artur Express, Inc.","Hazelwood","MO","767997","Artur Wagrodzki","President","www.arturexpress.com","General Freight","TTS Logistics LLC/Artur Express Freight Services/TAB","223893000","0","0","0","454","325","779","0","2636","2636","377","585","962"
"109","115","Venture Transport","Indianapolis","IN","911759","Doug Williams","President","www.venlog.com","General Freight","","-","0","0","0","562","338","900","1100","3120","4220","","","969"
"110","106","Premier Transportation","Forest Park","GA","282577","Michael Medici","CEO","www.premiertransportation.com","General Freight","","-","0","7","7","184","714","898","0","4332","4332","","","905"
"111","109","Smith Transport","Roaring Spring","PA","246204","Todd Smith","President","www.smithtransport.com","General Freight","","183000000","0","0","0","0","792","792","0","2200","2200","987","0","987"
"112","153","Tankstar USA, Inc.","Milwaukee","WI","","Jack Schwerman","President","www.tankstar.com","Tank/Bulk Commodities","","-","0","0","0","634","706","1340","1619","1471","3090","","","563"
"113","114","Dupre' Logistics, LLC","Lafayette","LA","214438","Raoul Siclait","CFO","www.duprelogistics.com","Tank/Bulk Commodities","Dupre' Logistics, LLC","294058258","0","0","0","0","650","650","0","1700","1700","732","112","844"
"114","90","TransAm Trucking, Inc.","Olathe","KS","315503","Russell McElliott","President","www.transamtruck.com","Refrigerated","","-","0","0","0","319","509","828","379","1536","1915","","","660"
"115","108","John Christner Trucking LLC","Sapulpa","OK","273897","John Christner","President & CEO","www.johnchristner.com","Refrigerated","John Christner Trucking LLC","322506365","0","0","0","700","0","700","0","1150","1150","","","735"
"116","117","J&R Schugel Trucking, Inc.","New Ulm","MN","116455","Rick Schugel","President","www.jrschugel.com","Refrigerated","","-","0","0","0","42","870","912","0","2086","2086","","","731"
"117","92","Acme Truck Line, Inc.","Gretna","LA","52767","Mike Coatney","President & Owner","www.acmetruck.com","Flatbed/Specialized/Heavy Haul","Acme Truck Line, Inc.","145000000","258","0","258","674","3","677","516","180","696","1100","0","1100"
"118","95","United Vision Logistics Holding Corp.","Lafayette","LA","286600","Rusty Guilbeau","CEO","www.visionlogisticsholding.com","Flatbed/Specialized/Heavy Haul","United Vision Logistics","192000000","191","0","191","751","0","751","940","0","940","0","860","860"
"119","116","Oak Harbor Freight Lines, Inc.","Auburn","WA","8314","Edward H. Vander Pol","Co-President & Co-Owner","www.oakh.com","General Freight","Oak Harbor Freight Lines, Inc.","-","0","51","51","0","763","763","0","2275","2275","","","989"
"120","124","Dependable Supply Chain Services","Los Angeles","CA","9853","Ronald Massman","CEO","www.godependable.com","General Freight","DHE/Dependable Highway Express, Inc./DHX Dependable Hawaiian Express/DLS/Dependable Logistics Solutions/DGX/Dependable Global Express","291000000","75","10","85","18","550","568","0","2200","2200","785","35","820"
"121","126","Navajo Express, Inc.","Denver","CO","202381","Don Digby, Jr.","CEO","www.navajoexpress.com","Refrigerated","Navajo Express, Inc.","240000000","0","0","0","50","750","800","0","2000","2000","650","50","700"
"122","118","Oakley Trucking","North Little Rock","AR","3259","Dennis Oakley","President","www.bruceoakley.com","Tank/Bulk Commodities","Oakley Trucking","-","0","0","0","872","0","872","0","952","952","","","872"
"123","111","Cassens Transport Co.","Edwardsville","IL","124358","Lisa Shashek","President","www.cassens.com","Motor Vehicles","Cassens Transport Co.","182117729","0","0","0","0","923","923","0","923","923","695","0","695"
"124","125","Venture Express, Inc.","La Vergne","TN","192068","Jimmy E Allen","President","www.ventureexpress.com","General Freight","","-","0","6","6","320","354","674","40","3259","3299","","","1074"
"125","132","Ozark Motor Lines, Inc.","Memphis","TN","96606","Steve Higginbotham","President","www.ozark.com","General Freight","","-","0","0","0","50","753","803","0","2230","2230","","","765"
"126","122","National Retail Systems, Inc.","North Bergen","NJ","","Raymond Wisniewski","President","www.nrsonline.com","Dedicated Contract Carriage","","-","17","13","30","485","334","819","1537","2726","4263","","","742"
"127","129","The Decker Companies","Fort Dodge","IA","53824","Donald L. Decker","Chairman","www.deckertruckline.com","General Freight","","-","0","0","0","27","762","789","0","1471","1471","","","782"
"128","130","K&B Transportation, Inc.","S. Sioux City","IA","320526","Kory Ackerman","Vice President","www.kbtransportation.com","Refrigerated","K&B Transportation, Inc.","180000000","0","0","0","740","0","740","1400","0","1400","730","0","730"
"129","128","TransX Ltd","Winnipeg","MB","180162","Mike Jones","COO","www.transx.com","General Freight","","-","0","0","0","663","45","708","0","2471","2471","","","892"
"130","134","Williams Brothers Trucking, Inc.","Hazlehurst","GA","156698","Roger L. Williams","President","www.wbtus.com","Flatbed/Specialized/Heavy Haul","","-","0","0","0","202","665","867","219","1362","1581","","","639"
"131","131","Beelman Truck Co.","East Saint Louis","IL","124260","Frank J. Beelman III","President","www.beelmantruck.com","Tank/Bulk Commodities","Sent email to Scott W","-","0","0","0","94","625","719","10","1115","1125","","","856"
"132","135","JBS Carriers, Inc.","Greeley","CO","184843","Rodrigo Horvath","President","www.jbscarriers.com","Refrigerated","JBS Carriers, Inc.","170218462","0","0","0","696","5","701","1000","571","1571","0","640","640"
"133","133","National Carriers","Irving","TX","69310","Jim Franck","President","www.nationalcarriers.com","Refrigerated","National Carriers, Inc.","195000000","0","0","0","200","449","649","1100","250","1350","430","200","630"
"134","141","Spee Dee Delivery Service, Inc.","Saint Cloud","MN","247570","Donald Weeres","President","www.speedeedelivery.com","Packages","","164500000","0","670","670","0","122","122","0","256","256","1170","0","1170"
"135","140","R.E. Garrison Trucking, Inc.","Cullman","AL","95610","Wyles Griffith","President","www.regarrison.com","Refrigerated","","-","0","1","1","54","584","638","1231","0","1231","","","704"
"136","138","American Bulk Commodities","Boardman","OH","255968","Mark A. Carrocce","President","www.rjtrucking.com","Tank/Bulk Commodities","R&J Trucking/John Brown Trucking/Southern Haulers/DSI Bulk Transport","138435503","0","50","50","29","640","669","29","1200","1229","550","125","675"
"137","139","Star Fleet Trucking, Inc.","Middlebury","IN","493424","Joel Pladson","President","www.starfleettrucking.com","Motor Vehicles","","-","0","0","0","604","0","604","29","7","36","","","751"
"138","127","Brown Integrated Logistics, Inc.","Lithonia","GA","186265","Scott Shephard","President/CEO","www.brownintegratedlogistics.com","General Freight","Brown Trucking Company","170057000","0","0","0","283","378","661","1407","1988","3395","434","168","602"
"139","171","Lily Transportation Corp","Needham","MA","24491","John Simourian II","President & CEO","www.lily.com","Dedicated Contract Carriage","","-","107","0","107","533","0","533","916","0","916","","","892"
"140","148","Ward Transport & Logistics","Altoona","PA","","Bill T. Ward","President","www.wardtlc.com","General Freight","Ward Trucking LLC/Ward Truckload Express LLC/Ward Logistics LLC","195225139","28","95","123","88","283","371","0","1055","1055","757","20","777"
"141","160","Jordan Carriers","Natchez","MS","","J. Ryan Wingfield","CFO","www.jordancarriers.com","Flatbed/Specialized/Heavy Haul","","148879652","0","0","0","103","524","627","0","695","695","484","103","587"
"142","152","Aim Integrated Logistics","Girard","OH","877115","Dave Gurska","COO","www.aimntls.com","Dedicated Contract Carriage","Aim Integrated Logistics Inc.","103400000","35","81","116","41","595","636","192","1176","1368","725","1","726"
"143","149","Blackhawk Transport","Beloit","WI","391460","Mike Holloway","President & CEO","www.blackhawktransport.com","Dedicated Contract Carriage","Blackhawk Transport Inc./Blackhawk Logistics LLC (dba Southwest Express)","130079993","11","21","32","30","552","582","40","1124","1164","603","30","633"
"144","154","Leonard's Express","Farmington","NY","920222","Ken Johnson","CEO","www.leonardsexpress.com","General Freight","","235187652","0","0","0","131","520","651","1009","0","788","392","108","500"
"145","159","Milan Supply Chain Solutions","Milan","TN","96609","John W. Ross","CEO","www.milanexpress.com","General Freight","","-","0","1","1","225","384","609","250","1711","1961","","","626"
"146","168","Halvor Lines, Inc.","Superior","WI","75250","Jon W. Vinje","CEO","www.halvorlines.com","General Freight","","125600000","0","0","0","186","423","609","10","1571","1581","504","104","608"
"147","155","Freymiller, Inc.","Oklahoma City","OK","963300","David Freymiller","Chief Executive Officer","www.freymiller.com","Refrigerated","","-","0","0","0","76","510","586","0","937","937","","","599"
"148","143","McElroy Truck Lines, Inc.","Cuba","AL","271424","C. Jay McElroy","President","www.mcelroytrucklines.com","Flatbed/Specialized/Heavy Haul","","-","0","0","0","8","584","592","0","1272","1272","","","676"
"149","163","Wayne Transports","Rosemount","MN","166179","Curtis M. Siemers","President","www.waynetransports.com","Tank/Bulk Commodities","","-","0","0","0","159","465","624","0","950","950","","","624"
"150","145","CalArk Inc.","Mabelvale","AR","546354","Rochelle Bartholomew","President","www.calark.com","General Freight","CalArk International Inc.","115205000","112","139","251","117","385","502","18","1519","1537","471","118","589"
"151","147","Eagle Transport Corp.","Rocky Mount","NC","90792","Lance R. Collette","President & COO","www.eagletransportcorp.com","Tank/Bulk Commodities","Eagle Transport Corp./ECO Energy Transport","131000000","0","0","0","0","480","480","3","525","528","730","0","730"
"152","156","Cliff Viessman, Inc.","Gary","SD","164259","Wayne Viessman","CEO","www.viessmantrucking.com","Tank/Bulk Commodities","Jacobson Transport Inc/GTI/Johnsrud","113875472","0","0","0","34","510","544","0","849","849","645","34","679"
"153","158","Danny Herman Trucking Inc.","Mountain City","TN","50467","Joe Herman","President","www.dannyherman.com","General Freight","Danny Herman Trucking","105763230","223","251","474","223","251","474","0","1216","1216","550","12","562"
"154","150","Fraley and Schilling, Inc.","Rushville","IN","125465","Ryan Schilling","Executive Vice President","www.fraleyandschilling.com","Flatbed/Specialized/Heavy Haul","","127000000","0","0","0","60","492","552","10","831","841","530","63","593"
"155","166","Cypress Truck Lines, Inc.","Jacksonville","FL","186106","Dave Penland, Sr.","President","www.cypresstruck.com","Flatbed/Specialized/Heavy Haul","Cypress Truck Lines/Sunbelt Transport LLC","114781133","0","0","0","0","650","650","0","2100","2100","538","0","538"
"156","181","Wiley Sanders Truck Lines, Inc.","Troy","AL","122275","Tres Parker","President","www.wsanders.com","General Freight","","111917125","0","0","0","289","280","569","0","1873","1873","605","0","605"
"157","136","B&W Cartage Company","Taylor","MI","128493","Stephen M. Klein","President","www.ilg.com","General Freight","","-","0","0","0","541","0","541","1581","0","1581","","","645"
"158","165","Pride Transport, Inc.","Salt Lake City","UT","236361","Jeffrey England, Jr.","Owner & CEO","www.pridetransport.com","Refrigerated","Pride Transport, Inc.","134000000","0","0","0","500","40","540","0","855","855","550","0","550"
"159","144","Benore Logistic Systems, Inc.","Erie","MI","1238256","Jeffery M. Benore","President","www.benorelogistics.com","General Freight","","-","0","0","0","24","473","497","759","793","1552","","","783"
"160","162","Venezia, Inc.","Royersford","PA","","Andrew J. Venezia","President & CEO","www.veneziatransport.com","Tank/Bulk Commodities","Venezia Hauling/Venezia Bulk Transport/Venezia Liquid Tank Lines/Venezia LPG Services/Venezia Transport Service Inc","106247783","0","0","0","62","544","606","0","1778","1778","517","54","571"
"161","146","Big G Express, Inc.","Shelbyville","TN","580685","Jack Marsh","CEO","www.biggexpress.com","General Freight","","-","0","0","0","562","15","577","774","1013","1787","","","548"
"162","151","Transportation Services, Inc.","Romulus","MI","198","Kenny Pellegrino","President & CEO","www.tsitrucks.com","General Freight","TSI","94120000","0","0","0","280","310","590","840","1020","1860","500","130","630"
"163","NR","GP Transco","Joliet","IL","1527352","Dominic Zastarskis","CEO","www.gptransco.com","General Freight","","96766882","0","0","0","20","701","721","104","391","495","368","104","472"
"164","172","Bulkmatic, LLC","Griffith","IN","76065","Chris Kravas","President","www.bulkmatic.com","Tank/Bulk Commodities","Bulkmatic/Paris Transport","135000000","0","0","0","0","500","500","0","1400","1400","500","0","500"
"165","167","West Side Transport, Inc.","Cedar Rapids","IA","165881","Donald Vogt","President & CEO","www.westsidetransport.com","General Freight","West Side Transport, Inc.","117978000","0","0","0","15","520","535","138","2131","2269","495","15","510"
"166","183","Oakley Transport, Inc.","Lake Wales","FL","281321","Thomas E. Oakley","President","www.oakleytransport.com","Tank/Bulk Commodities","","-","0","0","0","0","564","564","50","1291","1341","","","557"
"167","173","A.D. Transport Express Inc.","Canton","MI","192625","Gary A. Percy","President","www.adtransport.com","General Freight","AD Transport Express","104350000","0","0","0","0","555","555","0","1860","1860","538","8","546"
"168","170","Gypsum Express, Ltd.","Baldwinsville","NY","623098","John Wight","President","www.gypsumexpress.com","Flatbed/Specialized/Heavy Haul","Gypsum Express, Ltd.","117000000","0","0","0","0","550","550","0","1500","1500","470","0","470"
"169","184","Carroll Fulmer Logistics Corp.","Groveland","FL","1021374","Philip R. Fulmer","CEO","www.cfulmer.com","General Freight","Carroll Fulmer Logistics Corp.","132866933","0","1","1","32","461","493","0","1600","1600","381","80","461"
"170","182","Cargo Transporters, Inc.","Claremont","NC","257768","Dennis Dellinger","President & CEO","www.cargotransporters.com","General Freight","Cargo Transporters, Inc.","109000000","0","0","0","0","500","500","0","1800","1800","525","0","525"
"171","202","Bay & Bay Transfer Co., Inc.","Eagan","MN","125630","Sam Anderson","President","www.bayandbay.com","Refrigerated","Bay & Bay Transfer Co., Inc.","164149508","0","0","0","195","275","470","292","446","738","256","160","416"
"172","157","McClymonds Supply & Transit Co. Inc","Portersville","PA","269478","Mark McClymonds","President","www.mcclymonds.com","Tank/Bulk Commodities","McClymonds Supply and Transit","93286000","70","225","295","99","250","349","99","400","499","460","152","612"
"173","142","Action Enterprise Holdings, LLC","Birmingham","AL","","Staci Pierce","CEO","www.actn.com","Tank/Bulk commodities","Action Resources, LLC/Stone Trucking, LLC/ Action Environmental, LLC","-","0","0","0","284","234","518","138","964","1102","400","138","538"
"174","175","Admiral Merchants Motor Freight, Inc.","Minneapolis","MN","124813","Brian Short","President & CEO","www.ammf.com","Flatbed/Specialized/Heavy Haul","Admiral Merchants Motor Freight, Inc.","97186000","0","0","0","511","0","511","750","0","750","0","511","511"
"175","180","The Suddath Companies","Jacksonville","FL","","Michael J. Brannigan","President & CEO","www.suddath.com","Household Goods","The Suddath Companies","504143114","79","144","223","142","34","176","10","342","352","140","236","376"
"176","194","Western Dairy Transport LLC","Cabool","MO","1490474","David Shelton","CEO","www.wdtmilk.com","Tank/Bulk Commodities","","-","0","0","0","470","0","470","1299","0","1299","","","637"
"177","188","Sharkey Transportation, Inc.","Quincy","IL","55815","Jack Sharkey","","www.shke.com","General Freight","","-","0","0","0","531","0","531","1660","0","1660","","","442"
"178","174","Martin Transport, Inc.","Kilgore","TX","33094","Johnnie Murry","Sr. Vice President","www.martintransport.com","Tank/Bulk Commodities","","103969136","0","10","10","58","501","559","0","1159","1159","356","56","412"
"179","192","Midwest Transport, Inc.","Robinson","IL","1084722","Ken Hohlbaugh","President","www.mwtransport.com","General Freight","","-","0","14","14","0","421","421","0","636","636","","","646"
"180","193","Schuster Company","Le Mars","IA","69852","Steve Schuster","President","www.schusterco.com","Refrigerated","","109725500","0","0","0","70","410","480","0","950","950","380","70","450"
"181","177","Indian River Transport Co.","Winter Haven","FL","123611","John Harned","Owner","www.indianrivertransport.com","Tank/Bulk Commodities","","-","0","0","0","119","366","485","0","1118","1118","","","502"
"182","169","Beemac, Inc.","Ambridge","PA","388467","Loren Dworakowski","President & CEO","www.beemac.com","Flatbed/Specialized/Heavy Haul","","155615692","0","2","2","40","350","390","50","500","550","30","382","412"
"183","198","Hilco Transport","Greensboro","NC","328463","Jon Long","President","www.hilcotransport.com","Tank/Bulk Commodities","","-","0","81","81","88","341","429","50","774","824","","","483"
"184","213","TLD Logistics Services, Inc.","Knoxville","TN","1820774","David Jones","President and COO","www.tldlogistics.com","Dedicated Contract Carriage","","-","0","0","0","410","86","496","567","272","839","","","464"
"185","189","NAPA Transportation, Inc.","Mechanicsburg","PA","446997","Ronald Accomando","CEO","www.napatran.com","General Freight","","141523681","0","0","0","126","300","426","0","1500","1500","254","127","381"
"186","207","Heyl Truck Lines, Inc.","Akron","IA","65762","Alan Heyl","CEO","www.heyl.net","Refrigerated","Heyl Truck Lines","95657032","0","0","0","32","430","462","0","965","965","440","32","472"
"187","196","Hartt Transportation Systems, Inc.","Bangor","ME","184192","William A. Hartt","CEO","www.hartt-trans.com","General Freight","Hartt Transportation Systems, Inc.","152887686","2","0","2","24","370","394","0","2156","2156","375","24","399"
"188","214","Load One Transportation & Logistics","Taylor","MI","1112473","John Elliott","CEO","www.load1.com","General Freight","Load One","120500000","321","5","326","118","42","160","0","167","167","49","487","536"
"189","178","WEL Companies, Inc.","De Pere","WI","166046","Bruce Tielens","Chairman & CEO","www.welcompanies.com","Refrigerated","WEL Companies, Inc.","124252000","0","0","0","73","364","437","0","795","795","328","73","401"
"190","210","Titan Transfer, Inc.","Shelbyville","TN","845505","Phillip Edwards","President","www.titantransferinc.com","General Freight","","84975000","0","15","15","30","460","490","50","1550","1600","435","25","460"
"191","186","Combined Transport, Inc.","Central Point","OR","194077","Michael S Card","President","www.combinedtransport.com","Flatbed/Specialized/Heavy Haul","Combined Transport, Inc./Blackwell Consolidated","106237000","0","1","1","0","452","452","0","755","755","365","65","430"
"192","199","Fremont Contract Carriers","Fremont","NE","733","Tim McCormick","President & CEO","www.fcc-inc.com","General Freight","","-","0","1","1","117","329","446","0","1382","1382","308","117","425"
"193","164","M&M Transport Services, Inc.","Putnam","CT","342630","Mark Warsofsky","President","www.mmtransport.com","Dedicated Contract Carriage","M&M Transport Services, Inc.","-","0","24","24","0","451","451","0","0","0","","","485"
"194","197","Outwest Express LLC","El Paso","TX","2036998","Michael Puzio","President","www.outwestexpress.com","General Freight","Outwest Express","89900000","1","0","1","68","385","453","32","1230","1262","398","79","477"
"195","209","Nussbaum Transportation Services, Inc","Hudson","IL","71317","Brent Nussbaum","CEO","www.nussbaum.com","General Freight","","95489323","0","0","0","2","461","463","79","1065","1144","435","2","437"
"196","200","Saddle Creek Transportation Inc","Lakeland","FL","1196553","John Erwin","Vice President","www.sclogistics.com","General Freight","","-","0","0","0","51","362","413","1462","0","1462","","","581"
"197","204","Midwest Motor Express","Bismarck","ND","35207","Marlin Kling","President","www.mmeinc.com","General Freight","Midwest Motor Express","119000000","0","15","15","0","351","351","0","727","727","413","0","413"
"198","191","Buddy Moore Trucking, Inc.","Birmingham","AL","843883","Cary E. Moore","President & COO","buddymooretrucking.com","General Freight","Buddy Moore Trucking, Inc","84430316","70","300","370","70","300","370","31","750","781","300","70","370"
"199","205","Andy Transport, Inc.","Saint-Laurent","QC","1547667","Andreea Crisan","President & CEO","www.andytransport.com","General Freight","Tristan Cartage/Andy Warehousing & Distribution","-","0","0","0","0","415","415","0","915","915","430","80","510"
"200","195","Slay Transportation Co., Inc.","Saint Louis","MO","77890","Gary E. Slay","President","www.slay.com","Tank/Bulk Commodities","","-","0","0","0","273","214","487","105","1018","1123","","","392"
"201","201","PI&I Motor Express, Inc.","Sharon","PA","122443","Joseph J. Kerola","President","www.piimx.com","Flatbed/Specialized/Heavy Haul","PI&I Motor Express, Inc.","-","0","0","0","499","0","499","770","0","770","","","355"
"202","176","United Petroleum Transports, Inc.","Oklahoma City","OK","185040","Greg Price","President","www.otl-upt.com","Tank/Bulk Commodities","","-","0","0","0","243","173","416","29","658","687","","","498"
"203","206","Salem Carriers, Inc.","Winston Salem","NC","229354","Thomas Teague","President","www.salemcarriers.com","Dedicated Contract Carriage","Salem Carriers, Inc.","67507482","37","0","37","475","0","475","1625","0","1625","455","0","455"
"204","236","Lavalle Transportation, Inc.","Potsdam","NY","575205","Randy","Lavalle","www.lti.cc","General Freight","","-","0","0","0","271","154","425","0","1380","1380","","","440"
"205","218","Watsontown Trucking Company","Milton","PA","10715","Steve Patton","President","www.watsontowntrucking.com","General Freight","","89370000","0","2","2","0","425","425","140","1270","1410","390","20","410"
"206","185","Miller Truck Lines, LLC","Stroud","OK","125792","Bobby Miller","President","www.millertl.com","Flatbed/Specialized/Heavy Haul","","-","0","0","0","228","185","413","227","1100","1327","","","445"
"207","219","Poly Trucking, Inc.","Grand Prairie","TX","160955","Steven G. Ross","President","www.poly-trucking.com","General Freight","","-","0","18","18","0","475","475","0","962","962","","","270"
"208","216","Raven Transport Co., Inc.","Jacksonville","FL","268723","Stephen Silverman","COO","www.raventrans.com","General Freight","","-","0","0","0","446","1","447","1300","0","1300","","","364"
"209","242","Sweet Express LLC","Grand Rapids","MI","1128178","Damir Vidinlic","President","www.sweetexpressllc.com","General Freight","Sweet Express/Omni Transportation","71105000","0","3","3","46","465","511","0","880","880","295","71","366"
"210","215","Transystems LLC","Great Falls","MT","179858","Scott Lind","President","www.transystems.com","Tank/Bulk Commodities","","-","0","0","0","0","323","323","0","690","690","","","719"
"211","220","Transervice Logistics, Inc.","Lake Success","NY","620402","Gregg Nierenberg","President & CEO","www.transervice.com","General Freight","","-","10","6","16","287","41","328","0","0","0","571","0","571"
"212","217","Earl L Henderson Trucking Co., Inc.","Caseyville","IL","146458","Josh Kaburick","CEO","www.hendersontrucking.com","General Freight","","-","0","0","0","0","400","400","0","0","0","","","415"
"213","239","Charger Logistics","Griffith","IN","2014604","Andy Khera","President & CEO","www.chargerlogistics.com","General Freight","","-","0","0","0","175","198","373","105","0","105","","","453"
"214","235","Modern Transportation Services","Pittsburgh","PA","290790","Patrick Cozzens","President","www.moderntrans.com","Tank/Bulk Commodities","","76400000","0","0","0","360","2","362","431","137","568","375","71","446"
"215","203","Warren Transport","Waterloo","IA","1896","James Schommer","President","www.warrentransport.com","Flatbed/Specialized/Heavy Haul","","-","0","0","0","400","4","404","0","1300","1300","","","404"
"216","222","JNJ Express","Memphis","TN","655796","John Ennis","CEO","www.jnjexpress.com","General Freight","","-","0","0","0","400","0","400","14","1625","1639","","","400"
"217","224","J&M Tank Lines, Inc.","Birmingham","AL","184405","Harold Sumerford, Jr.","CEO","www.jmtank.com","Tank/Bulk Commodities","J&M Tank Lines, Inc.","74260000","0","0","0","385","15","400","500","200","700","400","10","410"
"218","212","D.M. Bowman, Inc.","Williamsport","MD","135530","James Ward","President & CEO","www.dmbowman.com","General Freight","D.M. Bowman, Inc.","91929589","0","0","0","0","382","382","0","1501","1501","320","0","320"
"219","229","CDN Logistics, Inc.","Northlake","IL","781203","Bob Heinz","President","www.gocdn.com","General Freight","","-","0","13","13","262","127","389","378","345","723","","","346"
"220","221","Service Transport Company","Houston","TX","229662","Wade Harrison","President","www.svtn.com","Tank/Bulk Commodities","Service Transport Company/EH Transport/CTL Transportation","71797000","0","0","0","77","375","452","40","1375","1415","256","77","333"
"221","223","G&D Integrated","Morton","IL","291139","Jeff Cohen","COO","www.gdintegrated.com","General Freight","G&D Integrated, Inc./G&D Integrated Transportation, Inc.","77121683","0","1","1","6","433","439","436","1696","2132","308","6","314"
"222","245","Penn Tank Lines, Inc.","Chester Springs","PA","264473","Jack A. McSherry, Jr.","President","www.penntanklines.com","Tank/Bulk Commodities","","-","0","0","0","277","118","395","37","465","502","","","376"
"223","233","Long Haul Trucking","Albertville","MN","282451","Jason Michels","CEO","www.longhaultrucking.com","Flatbed/Specialized/Heavy Haul","Long Haul Trucking","92500000","0","0","0","205","140","345","250","150","400","130","206","336"
"224","NR","KKW Trucking, Inc.","Pomona","CA","151877","Steve Benninghoff","COO","www.kkwtrucks.com","General Freight","KKW Trucking, Inc.","69009627","0","4","4","0","384","384","0","1177","1177","377","0","377"
"225","211","Coastal Transport Co., Inc.","San Antonio","TX","36647","Joe A. Morgan","President/COO","www.coastaltransport.net","Tank/Bulk Commodities","Coastal Transport Co., Inc.","-","0","0","0","0","350","350","0","402","402","","","429"
"226","208","Florida Rock & Tank Lines","Jacksonville","FL","29628","Robert E. Sandlin","President","www.floridarockandtanklines.com","Tank/Bulk Commodities","Florida Rock & Tank Lines/Danfair Transport","84131121","0","0","0","40","276","316","0","423","423","346","21","367"
"227","179","Midland Transport","Dieppe","NB","180155","Robert Irving","CEO","www.midlandtransport.com","General Freight","","-","0","0","0","296","46","342","0","1361","1361","","","404"
"228","225","N&M Transfer Co Inc","Neenah","WI","191755","Thomas Pawlacyk","President","www.nmtransfer.com","General Freight","","-","3","20","23","58","239","297","70","417","487","","","447"
"229","238","Kivi Bros Trucking","Duluth","MN","593718","Mark Kivi","President","www.kivibros.com","Flatbed/Specialized/Heavy Haul","","-","0","0","0","10","344","354","100","450","550","","","381"
"230","246","Andrus Transportation Services","Saint George","UT","167651","James R Andrus","President","www.andrustrans.com","General Freight","","-","0","0","0","105","241","346","0","1016","1016","","","375"
"231","227","Ergon Trucking","Jackson","MS","137758","Russ Maroney","President","www.ergon.com","Tank/Bulk Commodities","","-","0","0","0","209","168","377","33","476","509","","","342"
"232","228","L&B Transport LLC","Baton Rouge","LA","281216","Louie Vielee","Owner","www.landbtransport.com","Tank/Bulk Commodities","L & B Transport/Greenleaf Bulk Carriers, LLC/Trans Matic, Inc.","-","1","0","1","352","0","352","830","0","830","","","361"
"233","226","Royal Express","Laredo","TX","838117","Gume Garza","CEO","www.royalexpressinc.com","General Freight","","-","0","0","0","0","336","336","0","900","900","","","357"
"234","244","Metropolitan Trucking, Inc.","Bloomsburg","PA","39717","Joseph Mangino, Jr.","President","www.mtrk.com","General Freight","Metropolitan Trucking, Inc.","64982441","0","0","0","0","350","350","0","1160","1160","350","0","350"
"235","232","Don Hummer Trucking Corp.","Cedar Rapids","IA","307512","Chris Hummer","President","www.donhummertrucking.com","General Freight","","72000000","0","0","0","100","225","325","0","850","850","225","100","325"
"236","240","Andrews Logistics","Southlake","TX","736714","Darron Eschle","Chairman & CEO","www.andrewslogistics.com","Tank/Bulk Commodities","","-","0","0","0","4","350","354","0","1000","1000","","","319"
"237","241","McLeod Express","Decatur","IL","992986","Colt McLeod","President","www.mcleodexpress.com","General Freight","","75500000","0","0","0","0","295","295","0","989","989","305","10","315"
"238","247","Taylor Truck Line Inc.","Northfield","MN","124500","Rob Taylor","President","www.taylortruckline.com","General Freight","","-","0","0","0","68","256","324","13","1143","1156","","","324"
"239","NR","Butler Transport, Inc.","Kansas City","KS","324877","George Butler","President","www.butlertransport.com","Refrigerated","","70500000","0","0","0","0","300","300","0","590","590","300","0","300"
"240","187","Dillon Transport, Inc.","Burr Ridge","IL","297318","Jeff Dillon","President","www.dillontransport.com","Tank/Bulk Commodities","","-","0","0","0","0","323","323","0","531","531","","","342"
"241","NR","Risinger Bros. Transfer, Inc.","Morton","IL","244981","Stan Risinger","President","www.risingertrans.com","General Freight","","-","0","0","0","52","276","328","0","910","910","","","238"
"242","NR","Matheson Trucking, Inc.","Sacramento","CA","80612","Mark Matheson","CEO & President","www.mathesoninc.com","General Freight","","-","0","0","0","0","248","248","0","332","332","","","383"
"243","NR","Doug Andrus Distributing","Idaho Falls","ID","234","Clay Murdoch","CEO","www.dougandrus.com","Refrigerated","","75472659","0","1","1","106","160","266","353","164","517","243","9","252"
"244","NR","Whiteline Express LTD","Plymouth","MI","186721","William Young","President","www.whiteline-express.com","General Freight","","-","0","0","0","0","312","312","795","450","1245","","","306"
"245","NR","Indiana Western Express, Inc.","Springfield","MO","397707","Steven Coulter","President","www.iwxmf.com","Refrigerated","","-","0","0","0","0","274","274","0","321","321","","","333"
"246","NR","Penner International Inc","Steinbach","MB","36281","Allan Penner","President","www.penner.ca","General Freight","","-","0","0","0","222","48","270","0","793","793","","","349"
"247","NR","American Central Transport","Kansas City","MO","76198","Phil Wilt","President & COO","www.americancentral.com","General Freight","American Central Transport, Inc.","61000000","0","0","0","19","283","302","0","1","1","279","19","298"
"248","250","Southwestern Motor Transport, Inc.","San Antonio","TX","136555","Rick Eller","President","www.smtl.com","General Freight","","-","11","36","47","55","205","260","29","922","951","","","307"
"249","NR","Kriska Holdings LTD","Prescott","ON","297060","Mark Seymour","President","www.kriska.com","General Freight","","-","0","0","0","235","6","241","588","381","969","","","356"
"250","NR","KC Integrated Services","Carleton","MI","347778","Kenyon Calendar","CEO","www.kctrans.com","General Freight","","-","0","0","0","289","0","289","820","13","833","","","281"
